+---+---+---+
| + - * |   |
+ | + | +   +
| | | | |   |
+ | + | +   +
| * | * - * |
+---+---+   +