+---+---+---+---+---+
|   |   |   |   |   |
+   +   +   +   +   +
|   |   |       |   |
+   +   +   +   +   +
|       |   |   |   |
+---+   +   +---+   +
|   |           |   |
+   +---+   +   +   +
|           |       |
+---+---+---+---+---+